#tiles
0000000000000000
W00000000000000W
W00000000000000W
W00000000000000W
W000WWwWwwW0000W
W000W00000W0000W
W000W00000W0000W
W000W00P00W0000W
W000w00000W0000W
W000W00000w0000W
W000WWWWWww0000W
W00000000000000W
W00000000000000W
W00000000000000W
W00000000000000W
0000000000000000
#end