#tiles
WWWWW00000000000
W001W0zxc0000000
W0P0WWWWWWWWWWWW
W00000ZXC0W0000W
WWAWW00000D0000W
W000000000W0000W
WWBWWWWWWWW0000W
W00000000000000W
W00000000000000W
W00000000000000W
W00000000000000W
W00000000000000W
W00000000000000W
W00000000000000W
W00000000000000W
WWWWWWWWWWWWWWWW
#doors
A
B
D
#keys
1
2
#door_key_links
A1
B2
#xylophones
Z
X
C
=patterns
ZXC
ZXCX
#end
