WWWWWWWWWWWWWWWW
W000W0000000000W
W0P0W0000000000W
W000W0000000000W
WW0WW0000000000W
W00000000000000W
W00000000000000W
W00000000000000W
W00000000000000W
W00000000000000W
W00000000000000W
W00000000000000W
W00000000000000W
W00000000000000W
W00000000000000W
WWWWWWWWWWWWWWWW