#tiles
WWWWWWWWWWWWWWWW
W00000000000000W
W00000000000000W
W00000000000000W
W00000000000000W
W00000000000000W
W00000000000000W
W000000P0000000W
W00000000000000W
W00000000000000W
W00000000000000W
W00000000000000W
W00000000000000W
W00000000000000W
W00000000000000W
WWWWWWWWWWWWWWWW
#end
