#tiles
WWWWW00000000000
W001W0zxc0000000
W0P0WWWWWWWWWWWW
W000W0ZXC0WW000W
WWAWW00000d00R0W
W000000000WW000W
WWSWWWWGWWWW000W
WV00wvW2W00W000W
WB00wbWWWWWW000W
WN00wnWW0Q0W000W
WM00wmWW0P0WWHWW
WWWWWWWWWJWW000W
W000000w0000000W
WY00000w000T000W
W000000w0000000W
WWWWWWWWWWWWWWWW
#doors
A
S
d>r
G
H
J
#keys
1
2
#door_key_links
A1
S2
#xylophones
Z1
X2
C3
=patterns
ZXC
ZCXC
XXZCZ
=unlocks
G
#pianos
V2>l
B3>l
N1>l
M4>l
=unlocks
d
#gongs
RH
YJ
#tubas
T>u
#end
