#tiles
WWWWW00000000000
W001W0zxc0000000
W000WWWWWWWWWWWW
W000W0ZXC0WW000W
WWAWW00000d0000W
W000000000WW000W
WWSWWWWGWWWW000W
WV00wvW2W000000W
WBP0wbWWW000000W
WN00wnW00000000W
WM00wmW00000000W
WWWWWWW00000000W
W00000000000000W
W00000000000000W
W00000000000000W
WWWWWWWWWWWWWWWW
#doors
A
S
d
G
#keys
1
2
#door_key_links
A1
S2
#xylophones
Z1
X2
C3
=patterns
ZXC
ZCXC
XXZCZ
=unlocks
G
#pianos
V2
B3
N1
M4
=unlocks
d
#exit
Q
#end
