#tiles
WWWWWWWWWWWWWWWW
W001W0000000000W
W0P0W0000000000W
W000W0000000000W
WWAWW0000000000W
W00000000000000W
W00000000000000W
W00000000000000W
W00000000000000W
W00000000000000W
W00000000000000W
W00000000000000W
W00000000000000W
W00000000000000W
W00000000000000W
WWWWWWWWWWWWWWWW
#doors
A
B
#keys
1
2
#door_key_links
A1
B2
#end
