WWWWWWWWWWWWWWWWWWWWWWWWWWWWWWWW
W000000000000000000000000000000W
W000000000000000000000000000000W
W000000000000000000000000000000W
W000000000000000000000000000000W
W000000000000000000000000000000W
W000000000000000000000000000000W
W000000000000000000000000000000W
W000000000000000000000000000000W
W000000000000000000000000000000W
W000000000000000000000000000000W
W000000000000000000000000000000W
W000000000000000000000000000000W
W000000000000000000000000000000W
W000000000000000000000000000000W
W000000000000000000000000000000W
W000000000000000000000000000000W
W000000000000000000000000000000W
W000000000000000000000000000000W
W000000000000000000000000000000W
W000000000000000000000000000000W
W000000000000000000000000000000W
W00000000P000000000000000000000W
W000000000000000000000000000000W
W000000000000000000000000000000W
W000000000000000000000000000000W
W000000000000000000000000000000W
W000000000000000WWWWWWW000WWWWWW
W000000000000000W00000W000W0000W
W000000000000000W00P00000000000W
W000000000000000W00000W000W0000W
WWWWWWWWWWWWWWWWWWWWWWWWWWWWWWWW