#tiles
WWWWW00000000000
W001W0zxc0000000
W000WWWWWWWWWWWW
W000W0ZXC0W0000W
WWAWW00000D0000W
W000000P00W0000W
WWBWWWWWWWW0000W
W00000000000000W
W00000000000000W
W00000000000000W
W00000000000000W
W00000000000000W
W00000000000000W
W00000000000000W
W00000000000000W
WWWWWWWWWWWWWWWW
#doors
A
B
D
#keys
1
2
#door_key_links
A1
B2
#xylophones
Z1
X2
C3
=patterns
ZXC
ZCXC
XXZCZ
=unlocks
D
#end
