#tiles
WWWWW00000000000
W001W0zxc0000000
W000WWWWWWWWWWWW
W000W0ZXC0WW000W
WWAWW00000dP0R0W
W000000000WW000W
WWSWWWWGWWWW000W
WV00wvW2W00W000W
WB00wbWWW00W000W
WN00wnW0000W000W
WM00wmW0000WWHWW
WWWWWWW00000000W
W00000000000000W
W00000000000000W
W00000000000000W
WWWWWWWWWWWWWWWW
#doors
A
S
d
G
H
#keys
1
2
#door_key_links
A1
S2
#xylophones
Z1
X2
C3
=patterns
ZXC
ZCXC
XXZCZ
=unlocks
G
#pianos
V2
B3
N1
M4
=unlocks
d
#gongs
RH
#end
#exit
Q
