#tiles
0000000000000000
0000000000000000
0000000000000000
00WWwwwWwwWPW000
0WWW0000000WW000
0wWW0000000WW000
0wEW0000000WA000
0WWW000P000WW000
0WWB0000000WW000
0Www0000000Ww000
0wwW0000000ww000
00WWWAWWWwwwT000
0000000000000000
0000000000000000
0000000000000000
0000000000000000
#doors
A
#gongs
BC
#xylophones
E1
#tubas
T
#pianos
P2
#end