#tiles
................
................
................
....WWWWWWW.....
....W.....W.....
....W....YW.j...
....W.....W.....
.WWWW....TW.h...
.W#.A..@..W.....
.WWWW....RW.g...
....W.....W.....
....W....EW.f...
....W..J..W.....
....WWWWWWW.....
................
................
#doors
A
#pianos
E2>r
R2>r
T1>r
Y3>r
=unlocks
A
#xylophones
F1>d
G2
H3
J3
=patterns
FFGGHJJJ
#end
