#tiles
................
.....WWWWW......
.....W.#.W......
.....W...W......
.....WWAWW.z....
..WWWW...WWwWW..
..WZ.W.@.W..EWe.
..W..C...B..RWr.
..WX.WM..WL.TWt.
..WWWWwwwWWwWW..
.....W...W.x....
.....W...W......
.....W.G.W......
.....WWWWW......
................
................
................
#doors
A
B
C
#keys
L
#door_key_links
BL
#xylophones
E1
R2
T3
=patterns
TRE
TRRE
ETTRT
=unlocks
C
#gongs
GB
#pianos
X4>l
Z2>l
x4>d
z2>u
=unlocks
A
#maracas
M
#end
