#tiles
WWWWWWWWWWWWWWWW
W00000000000000W
W00000000000000W
W00000000000000W
W000WWWWWWWW000W
W000W000000W000W
W000W000000W000W
W000W00P000W000W
W000W000000W000W
W000w0WAW00W000W
W000w0WQW00W000W
WWWWWWWWWWWW000W
W00000000000000W
W00000000000000W
W00000000000000W
WWWWWWWWWWWWWWWW
#doors
A
#end
