#tiles
WWWWWWWWWWWWWWWW
W..............W
W.Y....O.....U.W
W..............W
W...WWwWWWww...W
W...W......W...W
W...W.R..WWW...W
W...W....a.W...W
W...w..@.W#W.S.W
W.T.w....WWW...W
W...w......W...W
WWWWWWwwWWWW...W
W..............W
W.G....D.....I.W
W..............W
WWWWWWWWWWWWWWWW
#doors
a
#tubas
R>r
T>u
Y>l
O>l
U>d
S>d
I>r
D>r
#gongs
GA
#end
