#tiles
..WWWWWWWWWWWWW.
..W.....w.....W.
..W.....w...G.W.
..W.....w.....W.
..W.....WWWWWWW.
..W..Y..W..W....
..W.....W..W....
..W..@..B.#W....
..W.....W..W....
..W..M..W..W....
..W.....WWWW....
..W.....W.......
..WWWAWWW.......
....WKW.........
....WWW.........
................
#doors
A
B
#keys
K
#door_key_links
BK
#gongs
GA
#tubas
Y>l
#maracas
M
#end
