#tiles
................
.....WWWWW......
.....W.#.W......
.....W...W......
.....WWAWW......
.....W...W......
.....W.@.W......
.....W...W......
.....W.T.W......
.....W...W......
.....W...W......
.....W...W......
.....WwwwW......
.....W.G.W......
.....WWWWW......
................
................
#doors
A
#gongs
GA
#tubas
T>d
#end
