#tiles
................
.....WWWWW......
.....W.#.W......
.....W...W......
.....WWAWW......
.....W...W......
.....W...W......
.....W.@.W......
.....W...W......
.....W.E.W......
.....WWWWW......
................
................
................
................
................
#doors
A
#pianos
E2>u
=unlocks
A
#end
R3>u
T2>u
