#tiles
................
.....WWWWW......
.....W.#.W......
.....W...W......
.....WWAWW......
.....WWBWW......
.....W...W......
.J...w.@.w....K.
.....W...W......
.....W.M.W......
.....W...W......
.....WCWDW......
.....WG.HW......
.....WWWWW......
................
................
................
#doors
A
B
C
D
#drums
GA
HB
JC
KD
#maracas
M
#end
