#tiles
................
.....WWWWW......
.....W.#.W......
.....W...W......
.....WWAWW......
.....W...W......
.....W...W......
.....W.@.W......
.....W...W......
.....WERTW......
.....WWWWW......
......ert.......
................
................
................
................
#doors
A
#xylophones
E1
R2
T3
=patterns
RET
=unlocks
A
#end
