#tiles
..WWWWW.........
..W..XWWW.......
..WZ..C.#.......
..WWBWWWW.......
..WWAWWWWWWWWWW.
..W@..w......HW.
..W.M.w......xW.
..W...w.......W.
..WwwwWWWWWWWWW.
..W...W.........
..W...W.........
..W...W.........
..W...W.........
..Wz..W.........
..W..GW.........
..WWWWW.........
#doors
A
B
C
#gongs
GA
#drums
HB
#maracas
M
#pianos
Z1>r
X4>l
z1>r
x4>l
=unlocks
C
#end
