#tiles
WWWWWWWWWWWWWWWW
W00000000000000W
W0Y0000O00000U0W
W00000000000000W
W000WWwWWWww000W
W000W000000W000W
W000W0R00WWW000W
W000W0000a0W000W
W000w00P0WQW0S0W
W0T0w0000WWW000W
W000w000000W000W
WWWWWWwwWWWW000W
W00000000000000W
W0G0000D00000I0W
W00000000000000W
WWWWWWWWWWWWWWWW
#doors
a
#tubas
R>r
T>u
Y>l
O>l
U>d
S>d
I>r
D>r
#gongs
GA
#end
