#tiles
WWWWW...........
W..1W.zxc.......
W.@.WWWWWWWWWWWW
W...W.ZXC.WW...W
WWAWW.....d..R.W
W.........WW...W
WWSWWWWGWWWW...W
WV..wvW2W..W...W
WB..wbWWWWWW...W
WN..wnWW.Q.W...W
WM..wmWW...WWHWW
WWWWWWWWWJWW...W
W......w.......W
WY.....w...T...W
W......w.......W
WWWWWWWWWWWWWWWW
#doors
A
S
d>r
G
H
J
#keys
1
2
#door_key_links
A1
S2
#xylophones
Z1
X2
C3
=patterns
ZXC
ZCXC
XXZCZ
=unlocks
G
#pianos
V2>l
B3>l
N1>l
M4>l
=unlocks
d
#gongs
RH
YJ
#tubas
T>r
#end
