#tiles
....W..W..W.W#W.
..WWRWWTWWYWWUWW
..W............W
..W.I..........W
..WW.WWWWWWWWWWW
...W.WW.WW.WW.W.
..WWFWWGWWHWWJWW
..W............W
..W.......L....W
..WWWWWWWW.WWWWW
...W.WW.WW.WW.W.
WWWWAWWBWWCWWDWW
Wvw............W
Wzw....K.......W
Wxw....@.......W
WWWWWWWWWWWWWWWW
#doors
A
B
C
D
F
G
H
J
R
T
Y
U
#keys
K
L
I
#door_key_links
AK
BK
CK
DK
FL
GL
HL
JL
RI
TI
YI
UI
#pianos
X3>u
Z1>u
V4>u
#end