#tiles
................
.....WWWWW......
.....W.#.W......
.....W...W......
.....WWAWW......
.....W...W......
.....W.1.W......
.....W...W......
.....W.@.W......
.....W...W......
.....WWWWW......
................
................
................
................
................
#doors
A
#keys
1
#door_key_links
A1
#end
